Population	SuperPop	Country
ACB	AFR	Barbados
ASW	AFR	United States of America
BEB	SAS	Bangladesh
CDX	EAS	China
CEU	EUR	United States of America
CHB	EAS	China
CHS	EAS	China
CLM	AMR	Colombia
ESN	AFR	Nigeria
FIN	EUR	Finland
GBR	EUR	United Kingdom
GIH	SAS	India
GWD	AFR	Gambia
IBS	EUR	Spain
ITU	SAS	India
JPT	EAS	Japan
KHV	EAS	Viet Nam
LWK	AFR	Kenya
MSL	AFR	Sierra Leone
MXL	AMR	Mexico
PEL	AMR	Peru
PJL	SAS	Pakistan
PUR	AMR	Puerto Rico
STU	SAS	Sri Lanka
TSI	EUR	Italy
YRI	AFR	Nigeria
